{
  "width": 16,
  "height": 16,
  "playerX": 3,
  "playerY": 2,
  "bitmap": [
    "################",
    "#              #",
    "#  @           #",
    "#  #           #",
    "#  #   ####    #",
    "#  #           #",
    "#  ######      #",
    "#           #  #",
    "#           #  #",
    "#           #  #",
    "#           #  #",
    "#           #  #",
    "#           #  #",
    "#              #",
    "#              #",
    "################"
  ]
}